NO ./assets/north.xpm
SO ./assets/south.xpm
WE ./assets/west.xpm
EA  ./assets/east.xpm


C 0,138,250
F 220,8,4

111111111111111111111111
1000000000110000000000011                                    1
1011000000111000000000000111
100100000000000001111000000011111          111111111111
111111011011000001110000000000001          1000000000001
100000000011000001110111111111111        11111111111111
11110111111111011100000010001
1111111111111111111111111111111
1100000000000000000000000000001
100000000000000000000000000001
1000000000000000000000000100001
1000000000000000000000000000001
11000000000000000000000000N0001
1111011111101011011111011001111
1111111111111111111111111111111
11111111 1111111 111111111111 1111111111111111
