C 220,100,0
F 220,100,0
NO ./path_to_the_north_texture    dddd dddd
SO ./path_to_the_south_texture





WE   ./path_to_the_west_texture


EA ./path_to_the_east_texture

1111    1111111111
100000000   000000001
10000W000  00001
1000000 0000001
11111   111111111

