NO ./assets/north.xpm
SO ./assets/south.xpm
WE ./assets/west.xpm
EA ./assets/east.xpm


C 220,10,250
F 220,0,0

1111111111111111111111111
1000000000110000000000011                                    1
1011000000111000000000000111
100100000000000001111000000011111          111111111111
111111011011000001110000000000001          100000000001
100000000011000001110111111111111        11111111111111
11110111111111011100000010001
11110111111111011101010010001
11000000110101011100000010001
11111111111111111111111111111
10000000000000011000000100011
10000000000000001101010010001
110000011101010111110111100N0111
11110111 1110101 101111010001
11111111 1111111 111111111111 1111111111111111
